barcodes	celltype_major
AAACGAAAGGTTGTTC	Myeloid.cells.Om
AAAGGTAAGCCTCAAT	T.cells.Om
AAAGTCCAGGTCTGGA	Mesothelial.cells.Om
AAAGTCCCACAGGATG	T.cells.Om
AAAGTCCCAGAACATA	T.cells.Om
AAAGTCCCAGAACCGA	T.cells.Om
AAAGTGATCCCAAGTA	T.cells.Om
AAATGGACAATCGTCA	T.cells.Om
AAATGGATCTCGGCTT	Mesothelial.cells.Om
AACAACCTCCCTGTTG	HGSOC
AACAACCTCTGTAACG	Myeloid.cells.Om
AACAAGAGTGGGCTTC	T.cells.Om
AACACACGTACACGCC	Fibroblasts.Om
AACACACGTACCTAAC	T.cells.Om
AACAGGGAGTGAACAT	Myeloid.cells.Om
AACAGGGCAATCGCGC	Myeloid.cells.Om
AACCATGTCGGTGCAC	T.cells.Om
AACCATGTCTGCTAGA	T.cells.Om
AACCCAAAGGTCCGAA	T.cells.Om
AACCTGAAGCCTAGGA	T.cells.Om
AACCTGAAGTATAGGT	T.cells.Om
AACGTCAAGCCTCTGG	T.cells.Om
AAGAACATCAGACCCG	Myeloid.cells.Om
AAGATAGCAATGTTGC	Myeloid.cells.Om
AAGCATCAGCCGGATA	Myeloid.cells.Om
AAGCGAGGTCGTACAT	Myeloid.cells.Om
AAGCGTTGTACGAGCA	Myeloid.cells.Om
AAGGTAAGTTCGTACA	Myeloid.cells.Om
AAGTACCTCACACCGG	Myeloid.cells.Om
AAGTACCTCTGCTGAA	Myeloid.cells.Om
AAGTTCGGTCTGCCTT	T.cells.Om
AATAGAGAGTCACACT	HGSOC
AATCACGCAAACGAGC	T.cells.Om
AATGACCGTTGGAGAC	T.cells.Om
AATGCCAGTTCTAACG	T.cells.Om
AATGCCATCTACCACC	T.cells.Om
AATGGCTTCGGAGTAG	T.cells.Om
AATTTCCAGGGCTTCC	Myeloid.cells.Om
ACAAAGAGTACTGCCG	T.cells.Om
ACACGCGCACTTGAGT	B.cells.Om
ACAGCCGAGTAAATGC	Myeloid.cells.Om
ACATTTCTCTCGAACA	Myeloid.cells.Om
ACCCTCAGTAGTGGCA	Myeloid.cells.Om
ACCTACCGTGCAACAG	Myeloid.cells.Om
ACCTACCGTGGGTTGA	B.cells.Om
ACCTGAAGTCAATCTG	T.cells.Om
ACGCACGTCCTCACCA	Mesothelial.cells.Om
ACGGTCGCACTCACTC	Myeloid.cells.Om
ACGGTTAAGGTACTGG	Myeloid.cells.Om
ACGTAACAGTGGTGGT	Myeloid.cells.Om
ACGTAACTCATTTGGG	T.cells.Om
ACGTCCTAGTCTCTGA	Myeloid.cells.Om
ACGTTCCTCACCTACC	B.cells.Om
ACTATGGTCTTTCTAG	T.cells.Om
ACTGCAACACTATCCC	Myeloid.cells.Om
ACTGCAAGTACGGATG	Myeloid.cells.Om
ACTGTCCCAGGCATGA	T.cells.Om
ACTGTCCGTCACTCGG	Myeloid.cells.Om
ACTGTGATCTTGTGCC	Fibroblasts.Om
ACTTAGGGTAACAAGT	T.cells.Om
ACTTTGTTCGATACAC	Mesothelial.cells.Om
AGAACAAAGACTCAAA	Mesothelial.cells.Om
AGAACAAGTTGCCATA	B.cells.Om
AGACAAACATACTTTC	T.cells.Om
AGACAAATCCCGGTAG	B.cells.Om
AGACAGGCATCCGATA	Mesothelial.cells.Om
AGACCCGGTCCTCAGG	T.cells.Om
AGACTCAAGCTGCCTG	T.cells.Om
AGACTCAAGGTGATCG	T.cells.Om
AGAGAGCTCGAGGCAA	Mesothelial.cells.Om
AGAGCCCTCGAGTGAG	HGSOC
AGATAGAAGGTAACTA	T.cells.Om
AGATGAACATTGCTTT	T.cells.Om
AGATGAATCTTAATCC	T.cells.Om
AGATGCTAGCGCTGAA	Myeloid.cells.Om
AGCCAATCACTCAAGT	T.cells.Om
AGCGATTCACCTTCGT	T.cells.Om
AGCGTATAGTTTCGAC	T.cells.Om
AGGAATACACGTTCGG	Myeloid.cells.Om
AGGAGGTAGCGATGCA	Mesothelial.cells.Om
AGGAGGTCACTACCCT	T.cells.Om
AGGCATTCAGACCTAT	T.cells.Om
AGGCATTGTTAGGCCC	T.cells.Om
AGGCTGCGTGCCGAAA	HGSOC
AGGGAGTAGGTGCTAG	Myeloid.cells.Om
AGGGCCTAGCAGTACG	T.cells.Om
AGGGCTCAGACCTTTG	T.cells.Om
AGGTCTACAGAGGCTA	Myeloid.cells.Om
AGGTTACAGATACAGT	Myeloid.cells.Om
AGGTTACGTCTTGAAC	T.cells.Om
AGGTTGTCAATTCACG	Fibroblasts.Om
AGTACTGAGTGACACG	Mesothelial.cells.Om
AGTACTGGTGATTGGG	T.cells.Om
AGTAGTCAGCGGCTCT	T.cells.Om
AGTCATGAGCTGTCCG	T.cells.Om
AGTCATGCACATACGT	T.cells.Om
AGTGACTAGTATGGCG	Fibroblasts.Om
AGTGACTAGTCCCAGC	T.cells.Om
AGTGATCAGGTTGTTC	HGSOC
AGTGCCGAGCGATGAC	T.cells.Om
AGTGCCGAGCGCCATC	T.cells.Om
AGTTCGAGTCGGTGTC	Myeloid.cells.Om
ATACCGAAGGGTAGCT	T.cells.Om
ATACCGATCCCTCTTT	Myeloid.cells.Om
ATAGAGACAATACGAA	Mesothelial.cells.Om
ATAGAGATCATCGCTC	T.cells.Om
ATAGAGATCTGTGCGG	T.cells.Om
ATAGGCTTCTATTCGT	T.cells.Om
ATCACGAGTTGGAGGT	T.cells.Om
ATCAGGTAGAAGTCCG	T.cells.Om
ATCATTCAGGTCGAGT	Fibroblasts.Om
ATCCATTAGACGAAGA	Fibroblasts.Om
ATCCATTGTGAGCGAT	B.cells.Om
ATCCCTGGTCTCAAGT	Myeloid.cells.Om
ATCGCCTCAGACTCTA	Myeloid.cells.Om
ATCGGATCAGTAGAGC	Fibroblasts.Om
ATCGTAGAGGTTACAA	T.cells.Om
ATCGTCCGTTATCCAG	T.cells.Om
ATCTCTAGTTGCATGT	Mesothelial.cells.Om
ATGACCAGTTTGAACC	Mesothelial.cells.Om
ATGAGGGCAGCCCACA	T.cells.Om
ATGATCGCAGCCTTCT	Myeloid.cells.Om
ATGATCGGTTCTCCCA	Myeloid.cells.Om
ATGATCGTCTCTCTTC	T.cells.Om
ATGCATGAGGTAGCAC	Myeloid.cells.Om
ATGCGATCACTCACTC	Myeloid.cells.Om
ATGCGATCATGGTACT	Myeloid.cells.Om
ATGCGATGTGTCCCTT	B.cells.Om
ATGGAGGCAGCGTTGC	T.cells.Om
ATGGAGGTCTCCATAT	Myeloid.cells.Om
ATGTCTTAGCACCGTC	Myeloid.cells.Om
ATGTCTTAGTCCTACA	Myeloid.cells.Om
ATGTCTTCATCAGCAT	T.cells.Om
ATGTCTTGTATCGTTG	T.cells.Om
ATTACCTCAGCACAGA	T.cells.Om
ATTACTCTCAAGGTGG	Myeloid.cells.Om
ATTATCCCACCAAATC	T.cells.Om
ATTATCCCATCTCCCA	Fibroblasts.Om
ATTCCATGTTGAGAGC	Myeloid.cells.Om
ATTCCTACAACGTAAA	Mesothelial.cells.Om
ATTCCTATCTCTGGTC	T.cells.Om
ATTCTTGAGTATGACA	Myeloid.cells.Om
CAAAGAAAGAAATTCG	Myeloid.cells.Om
CAACAACCACCCTATC	T.cells.Om
CAACAACGTAGTGATA	T.cells.Om
CAACAACGTTAGGCCC	B.cells.Om
CAACCTCCAAGGTCTT	T.cells.Om
CAAGCTAAGTGCCGAA	T.cells.Om
CAAGCTATCCTTCAGC	T.cells.Om
CAAGGGATCCGTACGG	T.cells.Om
CAATTTCCAAGGAGTC	Mesothelial.cells.Om
CAATTTCCATCGGTTA	Myeloid.cells.Om
CACAACAGTCTTTCAT	Myeloid.cells.Om
CACAGATAGTCAGCGA	T.cells.Om
CACAGGCCAGTAACCT	T.cells.Om
CACATGAGTCATATGC	T.cells.Om
CACATGATCCTTATGT	HGSOC
CACCGTTGTACGTGAG	T.cells.Om
CACGGGTGTAGCGCTC	T.cells.Om
CACGTGGAGTGTTCAC	Fibroblasts.Om
CACTAAGCATTGTGCA	T.cells.Om
CACTGAAAGTCAAGCG	Myeloid.cells.Om
CAGATACGTGCGAGTA	T.cells.Om
CAGATCAAGCGCTGCT	T.cells.Om
CAGATTGAGTATGAAC	Myeloid.cells.Om
CAGCAGCCATCGTTCC	Myeloid.cells.Om
CAGCGTGGTAGCCCTG	Fibroblasts.Om
CAGGTATCACAATGTC	Myeloid.cells.Om
CAGTTCCAGGGTCACA	Myeloid.cells.Om
CATACAGGTGGAACAC	T.cells.Om
CATACCCAGTAGAATC	HGSOC
CATACTTTCGGCCAAC	T.cells.Om
CATCAAGAGGGCAGAG	T.cells.Om
CATCCACAGTGAGCCA	T.cells.Om
CATCCACCAAGCTACT	Myeloid.cells.Om
CATCCCATCGTCACCT	Myeloid.cells.Om
CATCCCATCTTACCGC	T.cells.Om
CATCCGTCATCCCGTT	T.cells.Om
CATCCGTTCCTATGGA	T.cells.Om
CATCGGGAGAAGAACG	T.cells.Om
CATCGGGTCGCCTTGT	T.cells.Om
CATGAGTAGTTTGCTG	T.cells.Om
CATGCAAGTAGCTAAA	T.cells.Om
CATGCCTCAGCTATTG	T.cells.Om
CATGCCTGTCGAGCAA	Myeloid.cells.Om
CATGCTCTCAATCCGA	B.cells.Om
CATGGATCACAGCTGC	Fibroblasts.Om
CATGGATGTTCGGCTG	Myeloid.cells.Om
CATGGTAAGTCATCGT	T.cells.Om
CATGGTACACCATATG	T.cells.Om
CATTCTAAGCCTTGAT	Myeloid.cells.Om
CATTCTAGTCCTGGGT	T.cells.Om
CATTGCCCACGTTGGC	Fibroblasts.Om
CATTTCAGTGGATCGA	Fibroblasts.Om
CCAAGCGTCCACCCTA	T.cells.Om
CCAATTTCAGAGATGC	T.cells.Om
CCACGAGAGTCTTGGT	HGSOC
CCACGAGTCGGTCGAC	Fibroblasts.Om
CCATAAGAGGCCCACT	T.cells.Om
CCCGGAAAGATGCGAC	Myeloid.cells.Om
CCCGGAACACTTGGGC	T.cells.Om
CCCGGAAGTGGTAACG	T.cells.Om
CCCTAACAGGTAATCA	T.cells.Om
CCCTAACCAATAACGA	T.cells.Om
CCCTAACCAGACCTAT	T.cells.Om
CCCTCAATCTCGACCT	T.cells.Om
CCCTCTCCAAAGCGTG	T.cells.Om
CCCTCTCCATACACCA	Myeloid.cells.Om
CCCTGATGTGATTCTG	Myeloid.cells.Om
CCGGACAGTTGGGACA	T.cells.Om
CCGGACATCCCGAATA	T.cells.Om
CCGGTAGTCCGCATAA	Myeloid.cells.Om
CCGGTGAGTCTTTATC	T.cells.Om
CCGTAGGCACCAACAT	T.cells.Om
CCGTGAGAGTACGAGC	T.cells.Om
CCGTTCACAGACCCGT	Myeloid.cells.Om
CCGTTCATCGGAACTT	Myeloid.cells.Om
CCTACGTTCTTTCGAT	Myeloid.cells.Om
CCTCACACAATGTTGC	T.cells.Om
CCTCACATCTGAATGC	Mesothelial.cells.Om
CCTCAGTTCCGCATAA	T.cells.Om
CCTCCAACACACCTAA	T.cells.Om
CCTCTAGGTGACGCCT	HGSOC
CCTGCATGTAGGCTCC	T.cells.Om
CCTGTTGCAATCGCGC	Fibroblasts.Om
CCTTGTGTCTCAATCT	HGSOC
CCTTTGGTCTCGGGAC	T.cells.Om
CGAAGGAGTGCCTTCT	Myeloid.cells.Om
CGAAGTTCATCCGGCA	Myeloid.cells.Om
CGAATTGCATGAAAGT	T.cells.Om
CGACAGCAGACCAACG	Mesothelial.cells.Om
CGACAGCCACTAGGCC	HGSOC
CGATGGCTCTTAGGAC	Myeloid.cells.Om
CGCAGGTGTTCCTACC	Myeloid.cells.Om
CGCAGGTTCAATGTCG	T.cells.Om
CGCATAACAGCTATTG	T.cells.Om
CGCATAATCTGCCTCA	Myeloid.cells.Om
CGCATGGGTACGTTCA	Myeloid.cells.Om
CGCATGGTCAATCCGA	T.cells.Om
CGCCAGATCGCTAAAC	T.cells.Om
CGGAACCAGATTACCC	Myeloid.cells.Om
CGGAACCTCCCAGCGA	Fibroblasts.Om
CGGAACCTCTAGAGCT	Myeloid.cells.Om
CGGACACGTAAGGCCA	Myeloid.cells.Om
CGGGCATCAGGTGGAT	HGSOC
CGTAAGTAGGTAAAGG	Myeloid.cells.Om
CGTAGTAAGAGGCTGT	T.cells.Om
CGTAGTAAGGCCACCT	Myeloid.cells.Om
CGTAGTACACTCAAGT	T.cells.Om
CGTCAAAGTGCTCTCT	B.cells.Om
CGTCAAAGTTAGGGTG	T.cells.Om
CGTGAATCACTGGCGT	B.cells.Om
CGTTAGAAGATGACAT	Mesothelial.cells.Om
CGTTAGAGTAACTAAG	T.cells.Om
CTAACCCAGTCGAAGC	Fibroblasts.Om
CTACAGAGTTGCGGCT	Myeloid.cells.Om
CTACATTGTACGCGTC	Fibroblasts.Om
CTACCCATCCTTACCG	Myeloid.cells.Om
CTACCTGGTAGCGTAG	T.cells.Om
CTACCTGTCAAGAGGC	Myeloid.cells.Om
CTACTATGTAAGCGGT	T.cells.Om
CTACTATGTTCATCGA	T.cells.Om
CTCAAGAAGAATAGTC	Myeloid.cells.Om
CTCAATTTCGACACCG	HGSOC
CTCACTGGTCCTATAG	T.cells.Om
CTCAGTCAGTTGGAAT	T.cells.Om
CTCAGTCTCGCGTGAC	T.cells.Om
CTCATCGGTGTTCATG	T.cells.Om
CTCATGCAGCAGCGAT	HGSOC
CTCATGCGTTAAACCC	Fibroblasts.Om
CTCATTACAGTAGGAC	T.cells.Om
CTCGAGGGTGTCCACG	T.cells.Om
CTCTCAGCAAGACTGG	T.cells.Om
CTCTGGTCACAAGTTC	HGSOC
CTCTGGTGTGGACTAG	Myeloid.cells.Om
CTGAGCGGTCAGTCTA	Mesothelial.cells.Om
CTGCAGGTCGAGCTGC	T.cells.Om
CTGCAGGTCTTCCCAG	Fibroblasts.Om
CTGCGAGAGTGATAGT	Mesothelial.cells.Om
CTGGACGAGTAAATGC	Myeloid.cells.Om
CTGGTCTTCATGCATG	T.cells.Om
CTGTAGAAGTTCCATG	T.cells.Om
CTGTGAATCTGATTCT	T.cells.Om
CTTAGGAAGATGGTCG	T.cells.Om
CTTAGGATCACGTAGT	Myeloid.cells.Om
CTTCAATCACCAAAGG	T.cells.Om
CTTCAATGTATTTCTC	Myeloid.cells.Om
CTTCAATTCGAGAGAC	T.cells.Om
CTTCCGACAGCGTTGC	HGSOC
CTTCCGAGTACTCGTA	Myeloid.cells.Om
CTTCCGATCGAGTACT	T.cells.Om
CTTCCTTGTATGGAGC	Fibroblasts.Om
CTTCTCTAGTCATGAA	T.cells.Om
CTTCTCTCAAGTGGGT	T.cells.Om
CTTGAGAAGATGCCGA	T.cells.Om
CTTGAGATCTAGCAAC	HGSOC
CTTTCAAAGGAGCTGT	T.cells.Om
GAAACCTAGACCCTTA	T.cells.Om
GAAACCTAGGTCGACA	Myeloid.cells.Om
GAACTGTGTCGACTGC	Myeloid.cells.Om
GAAGAATCAGAATTCC	T.cells.Om
GAAGAATGTGACTATC	Mesothelial.cells.Om
GAAGAATTCTAGCCTC	Myeloid.cells.Om
GAAGCGATCATTTCGT	HGSOC
GAAGCGATCGTGAGAG	T.cells.Om
GAAGTAAAGAACTCCT	T.cells.Om
GAATAGAGTTGGCCTG	T.cells.Om
GAATAGATCCTATGGA	T.cells.Om
GAATCACAGACACACG	Mesothelial.cells.Om
GAATCACAGTCTACCA	Fibroblasts.Om
GACACGCAGACGCAGT	T.cells.Om
GACGCTGCAAGCTACT	T.cells.Om
GACGCTGTCTAGACAC	Myeloid.cells.Om
GACTATGAGTAGCAAT	T.cells.Om
GACTCAACACGACGTC	Mesothelial.cells.Om
GACTTCCAGTGCACCC	T.cells.Om
GAGAAATCAAAGCTCT	Fibroblasts.Om
GAGAAATCACGTACTA	Myeloid.cells.Om
GAGAAATTCATCGCTC	T.cells.Om
GAGACTTTCTGGTTGA	T.cells.Om
GAGCCTGCAAGAGGCT	T.cells.Om
GAGGGTAGTGGCTTAT	Myeloid.cells.Om
GAGTCTACATGTGTCA	Mesothelial.cells.Om
GAGTTTGGTGCCTACG	Myeloid.cells.Om
GATAGAACAACTTGCA	T.cells.Om
GATAGCTAGAGAGTTT	Myeloid.cells.Om
GATCGTAAGGTAACTA	Fibroblasts.Om
GATGAGGTCAAGTGGG	Fibroblasts.Om
GATGATCCAGCAGTCC	T.cells.Om
GATGCTAAGCCGCTTG	T.cells.Om
GATGCTATCAGCCTCT	Myeloid.cells.Om
GATGGAGAGCAACTTC	T.cells.Om
GATGGAGAGCTCATAC	Mesothelial.cells.Om
GATTCTTGTCTGTCAA	T.cells.Om
GCAACCGCACGGCACT	T.cells.Om
GCACGTGAGAGTTGAT	Myeloid.cells.Om
GCACGTGGTTACACTG	B.cells.Om
GCAGCCACATGAATAG	T.cells.Om
GCAGCTGCAGACATCT	Myeloid.cells.Om
GCAGGCTCACCTGCGA	Myeloid.cells.Om
GCAGGCTGTACGGCAA	Myeloid.cells.Om
GCATGATCACAAATCC	HGSOC
GCATGATTCAATCTCT	Myeloid.cells.Om
GCCAACGCATTAAGCC	Myeloid.cells.Om
GCCAACGGTACCTAAC	T.cells.Om
GCCAGGTAGACATAGT	T.cells.Om
GCCAGTGGTGGGTCAA	Fibroblasts.Om
GCCAGTGGTTCCGCGA	T.cells.Om
GCCCAGACAGTTACCA	T.cells.Om
GCCCAGACATGGATCT	Myeloid.cells.Om
GCCCAGATCGCCAATA	T.cells.Om
GCCCGAAAGGCTAAAT	T.cells.Om
GCCTGTTTCTCGTGGG	Fibroblasts.Om
GCGAGAAGTTCCGCAG	Myeloid.cells.Om
GCGAGAATCTGGCCGA	T.cells.Om
GCGTTTCGTGAGGATC	T.cells.Om
GCTACAAAGAATTGTG	Fibroblasts.Om
GCTGAATGTGGGCTTC	T.cells.Om
GCTGGGTAGCACGATG	B.cells.Om
GCTGGGTGTATTGGCT	T.cells.Om
GCTGGGTTCACAGTGT	Fibroblasts.Om
GCTTCACGTGAGAACC	HGSOC
GCTTCACTCCTCCACA	T.cells.Om
GCTTGGGAGAACCCGA	HGSOC
GGAACCCAGACTCCGC	Myeloid.cells.Om
GGAAGTGTCATGCCAA	T.cells.Om
GGAATGGTCGAGCCAC	Fibroblasts.Om
GGACGTCTCGCTAATG	Myeloid.cells.Om
GGAGAACTCGTCAGAT	Myeloid.cells.Om
GGAGATGCATAGGTAA	Myeloid.cells.Om
GGAGGTAGTCGCTGCA	Fibroblasts.Om
GGAGGTAGTTGCATCA	Mesothelial.cells.Om
GGATGTTCATAGAAAC	T.cells.Om
GGCACGTCAATGTGGG	T.cells.Om
GGCAGTCTCGACACTA	Fibroblasts.Om
GGCTGTGTCTGGACCG	Myeloid.cells.Om
GGCTTTCAGTCACTCA	Fibroblasts.Om
GGGAAGTGTCTACTGA	T.cells.Om
GGGACAACATTAAAGG	T.cells.Om
GGGACAATCTAACGGT	Mesothelial.cells.Om
GGGAGTAGTTGGGTAG	Myeloid.cells.Om
GGGAGTATCCTGCTAC	Myeloid.cells.Om
GGGATGAGTCTGTGCG	T.cells.Om
GGGCCATAGATGACCG	T.cells.Om
GGGCTCAAGCGCACAA	T.cells.Om
GGGTCTGTCACTGGGC	T.cells.Om
GGGTGTCTCGCCTTTG	T.cells.Om
GGTAATCGTTTACTTC	HGSOC
GGTCTGGAGACGGAAA	T.cells.Om
GGTGATTAGACTGAGC	Mesothelial.cells.Om
GGTGATTCAGAGGCAT	T.cells.Om
GGTTGTAAGACTACGG	T.cells.Om
GGTTGTATCACGGAGA	T.cells.Om
GTAACACGTGACACAG	Myeloid.cells.Om
GTAACCAAGACCCGCT	HGSOC
GTAACCAAGCAAACAT	T.cells.Om
GTAAGTCCATAGGTAA	HGSOC
GTAATCGCAGAAGTGC	Myeloid.cells.Om
GTAATGCAGTATCCTG	Mesothelial.cells.Om
GTAATGCTCGCCTTTG	Mesothelial.cells.Om
GTACAACCAACAGTGG	B.cells.Om
GTACAGTAGAAAGCGA	B.cells.Om
GTAGAAAAGTTATGGA	T.cells.Om
GTAGAAACACCCGTAG	T.cells.Om
GTAGATCGTGTTAAAG	T.cells.Om
GTAGATCGTTTCACTT	T.cells.Om
GTAGCTAAGGAGAATG	Mesothelial.cells.Om
GTAGCTATCACTTATC	HGSOC
GTAGGAGGTGGCTGCT	HGSOC
GTCAAACGTCGCCACA	T.cells.Om
GTCAAACTCAGTCCGG	T.cells.Om
GTCAAACTCAGTGCGC	T.cells.Om
GTCACGGAGGACACTG	T.cells.Om
GTCAGCGCAATCGCCG	T.cells.Om
GTCATGAGTTTCAGAC	Fibroblasts.Om
GTCATGATCAACGCTA	Fibroblasts.Om
GTCCCATCAGCTAACT	T.cells.Om
GTCCCATGTTCGTACA	HGSOC
GTCCTCAAGGTCCAGA	Myeloid.cells.Om
GTCCTCAGTTGCCTAA	T.cells.Om
GTCTAGACAAGTCGTT	T.cells.Om
GTCTGTCCAACTTGGT	T.cells.Om
GTCTTTATCGACGCGT	Myeloid.cells.Om
GTGACGCAGATTAGCA	T.cells.Om
GTGACGCTCTCTTAAC	T.cells.Om
GTGATGTGTTCTCTCG	T.cells.Om
GTGCACGAGCCACAAG	HGSOC
GTGCAGCGTCGCTCGA	T.cells.Om
GTGCTGGTCGTCCATC	T.cells.Om
GTGGAAGTCTCGACCT	Myeloid.cells.Om
GTGGAGATCGTTCGCT	Myeloid.cells.Om
GTGGGAACAGCTTTCC	Myeloid.cells.Om
GTGGTTAGTGAATGAT	Mesothelial.cells.Om
GTGTGATCACATACTG	Myeloid.cells.Om
GTGTGGCCACATAACC	Myeloid.cells.Om
GTGTTCCCAGCTTCGG	Myeloid.cells.Om
GTGTTCCTCCCAGCGA	Myeloid.cells.Om
GTTACAGCACTGCGTG	HGSOC
GTTACAGGTCTAGGTT	HGSOC
GTTAGACGTATCAGCT	Mesothelial.cells.Om
GTTAGTGCATCGAACT	HGSOC
GTTCATTAGATTACCC	Fibroblasts.Om
GTTCATTAGCTCTGTA	T.cells.Om
GTTCTATGTCTTTCAT	T.cells.Om
GTTGCGGAGGTACTGG	T.cells.Om
GTTGCGGCACCTCGTT	T.cells.Om
GTTGTAGGTATGGGAC	T.cells.Om
GTTTGGAAGCATGATA	Myeloid.cells.Om
TAACACGCACCAGGTC	T.cells.Om
TAACACGTCGGTCTAA	Mesothelial.cells.Om
TAACGACGTGGTGATG	T.cells.Om
TAACTTCGTCTGATCA	Myeloid.cells.Om
TAAGCGTCAGCTGTCG	T.cells.Om
TAATCTCGTAACATAG	T.cells.Om
TAATCTCGTAAGCGGT	Myeloid.cells.Om
TAATCTCTCAGGAAAT	Myeloid.cells.Om
TAATTCCCATTGCCTC	T.cells.Om
TACAACGAGCGAGGAG	T.cells.Om
TACACCCGTACAGTTC	Fibroblasts.Om
TACAGGTAGCATTGTC	T.cells.Om
TACATTCCACACCAGC	B.cells.Om
TACCCACAGGTGCCTC	Myeloid.cells.Om
TACCCACGTAACCAGG	T.cells.Om
TACCCACGTGAGAACC	Myeloid.cells.Om
TACCGGGCACAATCTG	T.cells.Om
TACCGGGTCCTACTGC	Myeloid.cells.Om
TACCTGCCAAGTCCCG	T.cells.Om
TACGGGCCAACACAGG	Myeloid.cells.Om
TACGGTACATCCTAAG	HGSOC
TACTGCCGTTGCACGC	T.cells.Om
TACTTACGTTAGAAGT	T.cells.Om
TACTTCACAATCCTTT	T.cells.Om
TAGACTGGTAGATTGA	T.cells.Om
TAGATCGCAGTTGTTG	HGSOC
TAGCACATCTACACTT	T.cells.Om
TAGGGTTAGAAGGATG	Fibroblasts.Om
TAGGTTGGTTATGACC	Myeloid.cells.Om
TATACCTAGGCAGCTA	Myeloid.cells.Om
TATACCTAGGGTGGGA	T.cells.Om
TATACCTAGGTCATCT	T.cells.Om
TATCAGGAGAAACTCA	Mesothelial.cells.Om
TATCCTACAGAGGCTA	Myeloid.cells.Om
TATCGCCGTTACACTG	Myeloid.cells.Om
TATCTTGCATGGCCCA	HGSOC
TATTTCGAGGTAGCAC	uncertain
TCAAGACCACATTCTT	HGSOC
TCAAGACGTACCGTGC	Myeloid.cells.Om
TCAAGTGAGCCGTAAG	Mesothelial.cells.Om
TCAATTCTCGATACAC	T.cells.Om
TCACAAGAGCCTCTTC	T.cells.Om
TCACAAGGTAGCTGAG	T.cells.Om
TCACAAGTCACACCGG	Mesothelial.cells.Om
TCACAAGTCGATTCCC	HGSOC
TCACGCTAGCGATCGA	Myeloid.cells.Om
TCACTCGCATTGTCGA	Mesothelial.cells.Om
TCAGCAACAGCCGTCA	T.cells.Om
TCAGCAAGTGCCTTTC	T.cells.Om
TCAGCCTGTCTCAAGT	Myeloid.cells.Om
TCAGGTAAGTTTCTTC	Fibroblasts.Om
TCAGTGAAGATTGATG	Myeloid.cells.Om
TCAGTGAAGCCAGAGT	Fibroblasts.Om
TCAGTGATCACATACG	T.cells.Om
TCATATCAGAATTTGG	Fibroblasts.Om
TCATATCAGGGATCTG	T.cells.Om
TCATCATCAGCCTTCT	HGSOC
TCATGAGGTTGGGTTT	T.cells.Om
TCATGTTCAGCAGTCC	T.cells.Om
TCATGTTCAGGGAATC	Myeloid.cells.Om
TCATTACGTCACCACG	HGSOC
TCATTCAAGTGCTAGG	T.cells.Om
TCATTCACATACTTTC	T.cells.Om
TCATTCACATCGTGCG	T.cells.Om
TCATTTGAGGTCGTAG	T.cells.Om
TCATTTGGTGTGTTTG	HGSOC
TCCACCAAGGTTAGTA	Myeloid.cells.Om
TCCACGTTCTCCATAT	T.cells.Om
TCCATCGAGGTCCCGT	Myeloid.cells.Om
TCCATGCTCGCAGTGC	Myeloid.cells.Om
TCCCACAAGTCTCCTC	Myeloid.cells.Om
TCCCATGAGGCGACAT	Mesothelial.cells.Om
TCCGTGTTCAGAGTTC	B.cells.Om
TCCTCCCAGCACACCC	T.cells.Om
TCGAAGTCAGCGTATT	T.cells.Om
TCGATTTAGGCTAACG	T.cells.Om
TCGCACTAGGCTGAAC	T.cells.Om
TCGCAGGCAATGCAGG	T.cells.Om
TCGCAGGGTTGCCGAC	Fibroblasts.Om
TCGGATACATCCGCGA	Myeloid.cells.Om
TCGGGCAGTTAGAAAC	T.cells.Om
TCGGTCTGTACTTGTG	Myeloid.cells.Om
TCGTGCTCACCATTCC	T.cells.Om
TCGTGCTGTACACGCC	Fibroblasts.Om
TCTAACTAGCCAAGCA	T.cells.Om
TCTAACTCATCTGCGG	T.cells.Om
TCTAACTGTATGCGTT	T.cells.Om
TCTAACTTCACTTTGT	T.cells.Om
TCTACATTCATTGTTC	T.cells.Om
TCTACATTCCGTTGAA	T.cells.Om
TCTACATTCTCTTAAC	HGSOC
TCTCACGTCATGTCTT	Myeloid.cells.Om
TCTCAGCGTACGGTTT	T.cells.Om
TCTCTGGAGATCGCTT	T.cells.Om
TCTCTGGTCATCCTGC	HGSOC
TCTGCCAGTAGGAAAG	HGSOC
TCTGGCTCAACTGCCG	Fibroblasts.Om
TCTGTCGCATCATTTC	T.cells.Om
TCTGTCGTCAGCTTCC	B.cells.Om
TGAACGTAGCCAGAGT	Myeloid.cells.Om
TGAACGTCAGTCCGTG	Myeloid.cells.Om
TGAATGCAGATAACGT	Fibroblasts.Om
TGAATGCAGGTCACAG	T.cells.Om
TGACAGTAGAGTTGTA	T.cells.Om
TGACCCTAGATGGCGT	HGSOC
TGACTCCCATCCGAAT	Myeloid.cells.Om
TGAGCATGTATTTCCT	T.cells.Om
TGAGCGCAGGTGCCAA	Mesothelial.cells.Om
TGAGCGCTCAGCATTG	T.cells.Om
TGAGCGCTCCCTCGAT	Myeloid.cells.Om
TGAGGTTAGTTGCTGT	T.cells.Om
TGAGGTTGTCAGCTTA	T.cells.Om
TGAGTCACATCACCAA	Myeloid.cells.Om
TGATCAGCATCCGATA	B.cells.Om
TGATGGTCAACACAAA	T.cells.Om
TGATGGTGTTACCCAA	Myeloid.cells.Om
TGATTTCAGACTGAGC	T.cells.Om
TGATTTCTCAGCTCTC	Mesothelial.cells.Om
TGCAGATAGCTGGCTC	T.cells.Om
TGCAGTATCTCCCAAC	T.cells.Om
TGCATGAAGAAACTCA	T.cells.Om
TGCATGATCACCCATC	Myeloid.cells.Om
TGCCGAGCAAGTCATC	Myeloid.cells.Om
TGCGACGTCCATAGGT	Myeloid.cells.Om
TGCGGGTAGGGTAGCT	T.cells.Om
TGCTCGTTCTGCACCT	T.cells.Om
TGCTGAAGTGTCCCTT	HGSOC
TGCTTCGTCACCATAG	Mesothelial.cells.Om
TGGATCAAGCAAACAT	T.cells.Om
TGGATGTCACCGTCGA	T.cells.Om
TGGGAGAAGGTTGGAC	T.cells.Om
TGGGATTAGCTTTGTG	T.cells.Om
TGGGCGTAGCACCTGC	Myeloid.cells.Om
TGGTGATGTTTGGGAG	Myeloid.cells.Om
TGGTGATTCCGAGGCT	T.cells.Om
TGTCCACGTTCTTGTT	B.cells.Om
TGTCCTGCAACCGCTG	Myeloid.cells.Om
TGTGAGTGTCCTTTGC	Myeloid.cells.Om
TGTGGCGGTCGAGCAA	T.cells.Om
TGTTACTTCGAATGCT	T.cells.Om
TGTTACTTCGGACTTA	T.cells.Om
TGTTCTAAGCTCCACG	Fibroblasts.Om
TGTTGAGTCTGCCTCA	Myeloid.cells.Om
TTAATCCAGCGAATGC	Mesothelial.cells.Om
TTAATCCGTCCTGAAT	T.cells.Om
TTAATCCGTTGTCAGT	B.cells.Om
TTACAGGCAATACGCT	Myeloid.cells.Om
TTACCATCACAGGATG	Myeloid.cells.Om
TTACCATCAGACTCTA	Myeloid.cells.Om
TTACCATCAGGAACCA	T.cells.Om
TTACCGCAGGACAGCT	Myeloid.cells.Om
TTACGCCCACGACGTC	B.cells.Om
TTACGCCCAGAGAATT	Myeloid.cells.Om
TTACGCCTCCACCCTA	Myeloid.cells.Om
TTACGTTAGGTCACTT	Myeloid.cells.Om
TTACTGTCAGCTACTA	T.cells.Om
TTACTGTTCGGCTGTG	T.cells.Om
TTAGGCAGTATCTTCT	Myeloid.cells.Om
TTAGGGTAGTAAAGCT	Myeloid.cells.Om
TTAGTCTCACAGCCAC	T.cells.Om
TTCAATCAGTGGCGAT	HGSOC
TTCAATCGTCTGCGCA	T.cells.Om
TTCCAATGTCACAGTT	T.cells.Om
TTCCACGAGCAACAGC	T.cells.Om
TTCCGTGGTTCGGTTA	T.cells.Om
TTCCTAATCCTCTAAT	uncertain
TTCCTCTAGGGCGAGA	Myeloid.cells.Om
TTCCTCTCAAAGCAAT	T.cells.Om
TTCCTTCCACTAGGTT	Fibroblasts.Om
TTCGCTGGTCAATCTG	Myeloid.cells.Om
TTCGCTGGTCTAACTG	T.cells.Om
TTCTAACGTGCAATGG	HGSOC
TTCTAGTAGCCAAGCA	T.cells.Om
TTCTCTCCAAAGGAGA	Myeloid.cells.Om
TTCTCTCTCTTCGTGC	T.cells.Om
TTCTGTAGTCAGTCCG	Myeloid.cells.Om
TTCTTGACAAGAATGT	HGSOC
TTCTTGACAGATTCGT	T.cells.Om
TTCTTGATCCACAGGC	T.cells.Om
TTGAACGAGCCGTTAT	T.cells.Om
TTGAACGCAGATTTCG	Myeloid.cells.Om
TTGAACGTCAGAATAG	Myeloid.cells.Om
TTGACCCTCTCTATAC	T.cells.Om
TTGAGTGTCAGCGCGT	Myeloid.cells.Om
TTGATGGAGGTGCTAG	Mesothelial.cells.Om
TTGCCTGCATACTGTG	Fibroblasts.Om
TTGCGTCTCTTCGATT	T.cells.Om
TTGGATGTCACTCGAA	Myeloid.cells.Om
TTGTGGAGTGAGTTTC	Myeloid.cells.Om
TTGTTCAGTGGATCAG	T.cells.Om
TTTACCAAGAGCCATG	T.cells.Om
TTTACGTGTATCCCAA	HGSOC
TTTACTGAGACTACGG	T.cells.Om
TTTCACATCGATCCCT	T.cells.Om
TTTCATGTCCAGTGTA	T.cells.Om
TTTCATGTCTAGCAAC	T.cells.Om
TTTCCTCAGCTGGCCT	Myeloid.cells.Om
TTTCCTCCAAGCACAG	T.cells.Om
TTTCCTCGTGATCATC	T.cells.Om
TTTCGATGTAGGTACG	T.cells.Om
TTTGGTTCAGACACCC	T.cells.Om
