barcodes	celltype_final
AAACCCACAGAAATTG	MG
AAACGCTAGGATGTTA	MG
AAACGCTCAGAGCGTA	MG
AAAGGATCACGATAGG	MG
AAAGGGCCATGACACT	AC/HC
AAAGGTACACCCATAA	MG
AAATGGAAGCGACTTT	MG
AAATGGAAGGGAGTTC	Cones
AACAACCTCGTGCACG	PRP
AACAAGACACGCTGCA	Cones
AACAAGATCTACCAGA	MG
AACACACAGAACAAGG	MG
AACAGGGCAAGAGATT	MG
AACCAACAGTCGGGAT	Cones
AACCTTTAGGGACCAT	AC/HC
AACCTTTCACCGCTAG	AC/HC
AACCTTTCAGTTGTCA	MG
AACGAAACACGTAACT	MG
AACGTCAAGCGACATG	MG
AACGTCACAACGTAAA	Rods
AAGAACACATGTTCAG	MG
AAGAACATCACTCACC	MG
AAGACTCCAGACCAGA	PRP
AAGATAGGTCGTTGGC	MG
AAGGAATAGTGTGTTC	MG
AAGGAATCAATAACCC	MG
AAGGAATCAGTCACGC	MG
AAGGTAACAGCCCACA	PRP
AAGTACCCATTGCTTT	MG
AAGTACCTCAGACCGC	AC/HC
AAGTCGTTCCTACTGC	PRP
AAGTGAAAGTCCCAAT	Cones
AAGTGAACATGTGTCA	PRP
AATCACGAGAGCAACC	PRP
AATCACGCATGAAGCG	PRP
AATCACGGTGGCTGAA	PRP
AATCGACAGAAGTGTT	MG
AATCGACCAGCGTAGA	MG
AATCGTGCATCGTGCG	MG
AATGGAACAATAACCC	MG
AATGGCTCAGTAGTGG	MG
AATGGCTGTTTAGAGA	MG
ACAAGCTCAGTTCTAG	MG
ACAAGCTGTATGAAGT	MG
ACAAGCTGTTGTTGCA	PRP
ACACCAACAGCACGAA	MG
ACACCAAGTTATCTGG	MG
ACACTGACACAACGAG	MG
ACACTGACAGGCCTGT	MG
ACAGCCGAGCACTCTA	MG
ACAGCCGGTGTCATTG	MG
ACAGGGATCTAGTCAG	MG
ACATCCCAGCGAGGAG	PRP
ACATCCCGTCTTTATC	BC
ACATCGAGTAGCCAGA	MG
ACATCGATCGTCAAAC	MG
ACATCGATCTGGCTGG	AC/HC
ACATGCACACAAATCC	MG
ACATTTCGTTCCAAAC	MG
ACCAACAAGCTGTTAC	MG
ACCAACACACAGAAGC	AC/HC
ACCAACACATCTGGGC	AC/HC
ACCAACACATTCTTCA	PRP
ACCAACATCGTTGTTT	MG
ACCACAAAGAGAGTGA	MG
ACCACAATCAAGCCAT	MG
ACCACAATCGCAGTTA	MG
ACCCAAAAGCTCCGAC	PRP
ACCCAAAGTCGCTGCA	MG
ACCCTTGAGATTGCGG	PRP
ACCCTTGAGCAGTAAT	MG
ACCTACCTCGTCGACG	MG
ACGATCAGTACGCTTA	MG
ACGGGTCCAAGCGGAT	MG
ACGGGTCGTTGCTGAT	MG
ACGGTCGAGAGACAAG	MG
ACGGTCGTCAGCCCAG	Cones
ACGGTCGTCTGGGTCG	PRP
ACGTAACCAAAGGATT	PRP
ACGTAACTCGACATAC	MG
ACGTAGTCAAAGACTA	AC/HC
ACGTCCTTCGATGCAT	PRP
ACGTTCCCAAATACAG	MG
ACTACGAAGTGCGTCC	PRP
ACTATCTGTAAGACCG	PRP
ACTATCTGTATCAGCT	PRP
ACTATGGCAGAGTCTT	MG
ACTATGGGTATAGGAT	AC/HC
ACTATTCAGTGGAAGA	PRP
ACTATTCCATGGGTCC	PRP
ACTCTCGCAACCGTGC	PRP
ACTGATGCAACTTGGT	MG
ACTGCAAGTCAGTCTA	Cones
ACTGTCCAGTCGAGGT	PRP
ACTGTCCGTCCATAGT	MG
ACTTAGGGTATCGTGT	MG
ACTTAGGTCGTCAAAC	MG
ACTTCCGCAGAGTCAG	MG
ACTTCCGCATCAGTCA	PRP
ACTTCGCTCCAGCAAT	MG
ACTTTCACAAAGAACT	AC/HC
ACTTTCATCCATACTT	MG
ACTTTGTAGTCGAAGC	PRP
ACTTTGTTCTTCACAT	MG
AGAACAATCGCACGAC	MG
AGAAGCGAGGAGAATG	MG
AGAAGCGCAAGTACCT	PRP
AGAAGCGGTTACACAC	PRP
AGAAGTACATTCACAG	PRP
AGAAGTATCAAGGCTT	MG
AGACACTGTGAGTCAG	Cones
AGACCATCAGTCAACT	PRP
AGACCATGTAAGCGGT	MG
AGACCCGGTTAACCTG	MG
AGACTCATCTAGATCG	PRP
AGAGAATCACCAGGTC	AC/HC
AGATCCACAACAGATA	PRP
AGCCACGAGTCCTGCG	Cones
AGCCACGTCGACCTAA	PRP
AGCGATTAGGGTACAC	MG
AGCGCCAGTTGCCATA	MG
AGCGCTGCAACAAGAT	AC/HC
AGCGCTGGTCTTAGTG	PRP
AGCGTATCAACAAAGT	MG
AGCGTATGTTTCACAG	MG
AGCGTATTCCCATGGG	MG
AGCTACAGTCTTCGAA	MG
AGCTCAAAGTCAGAGC	PRP
AGCTCAATCCTGCCAT	PRP
AGCTTCCCATTCGGGC	MG
AGGACGAAGACGACTG	PRP
AGGACTTCACAATGTC	MG
AGGAGGTCATAGGTTC	PRP
AGGAGGTGTCGTGCCA	AC/HC
AGGAGGTTCCTGGTCT	MG
AGGATAACAGCATGCC	MG
AGGATAATCCCTCATG	AC/HC
AGGCATTAGCTTCGTA	MG
AGGCATTGTATGATCC	Cones
AGGCCACCACGTAACT	PRP
AGGCTGCCACCCATAA	PRP
AGGCTGCTCGTAGCCG	PRP
AGGGAGTCACCAGCGT	MG
AGGGAGTGTACAGCGA	PRP
AGGGAGTGTTCGGTTA	PRP
AGGGAGTGTTTACTTC	MG
AGGGAGTTCCTCTTTC	PRP
AGGGTCCTCAACGAGG	PRP
AGGGTGAAGACTTCAC	PRP
AGGGTGACACGTACTA	MG
AGGTGTTTCCGAAGGA	PRP
AGGTTACTCATGAGTC	MG
AGTAACCCATGACGTT	MG
AGTAACCTCACACCCT	Cones
AGTAACCTCCACGTAA	PRP
AGTACTGCAGCTCGGT	PRP
AGTAGTCAGTAAACAC	MG
AGTAGTCTCCGATAAC	MG
AGTCAACGTCGCCTAG	MG
AGTCAACGTGACCTGC	PRP
AGTCTCCAGCGACTAG	MG
AGTCTCCCAGTCTCTC	AC/HC
AGTGATCAGACTACGG	PRP
AGTGATCAGCAATAAC	PRP
AGTGATCAGCACTCGC	MG
AGTGATCCAGCCTTCT	Cones
AGTGTTGAGAGCCATG	MG
AGTGTTGCACTAAACC	MG
AGTGTTGGTTACCTGA	AC/HC
AGTTCCCAGACATAAC	MG
AGTTCGAAGGTTAGTA	PRP
AGTTCGATCACCTGGG	PRP
AGTTCGATCGATTGAC	MG
AGTTCGATCTTGATTC	PRP
ATACCGAGTAAGGAGA	MG
ATACCTTAGTGCCGAA	PRP
ATACCTTAGTTAGTGA	PRP
ATACCTTGTGACTCGC	AC/HC
ATACTTCAGACACACG	MG
ATACTTCCAATGCAGG	MG
ATACTTCTCATGCAGT	MG
ATAGAGAAGGTCGTGA	MG
ATAGAGATCTCGTCAC	MG
ATAGGCTAGTCTGTAC	PRP
ATAGGCTCAGCCTACG	MG
ATATCCTGTGGTACAG	MG
ATCACAGTCCCGAAAT	MG
ATCACTTCAGAGAATT	MG
ATCAGGTAGACTACGG	PRP
ATCCATTCATTGCTTT	PRP
ATCCCTGCAAGGAGTC	MG
ATCCCTGCATCGATGT	MG
ATCCGTCAGCTTTCTT	PRP
ATCCGTCCAGGCTATT	AC/HC
ATCCGTCGTAGCTGAG	PRP
ATCCTATCAGAGATGC	PRP
ATCCTATCAGTTGGTT	MG
ATCCTATGTGTACATC	Cones
ATCCTATTCTATCGTT	MG
ATCCTATTCTGTGTGA	MG
