barcodes	celltype_final
AAACCCAAGATTGACA	Rods
AAACCCAGTCACAGTT	Rods
AAACCCAGTTCTTGTT	BC
AAACCCATCCTATTTG	Rods
AAACCCATCCTTCGAC	Rods
AAACCCATCTAGGAAA	AC/HC
AAACGAATCATTACCT	Cones
AAACGCTAGAGCCTGA	Rods
AAACGCTAGTTTCGGT	MG
AAACGCTCAGTAGTTC	MG
AAAGAACAGAGACAAG	MG
AAAGAACCAGCTTCGG	MG
AAAGAACGTGGCTCTG	Rods
AAAGGATAGTGCAGCA	Rods
AAAGGATCACCCTTAC	Cones
AAAGGATGTATGCTAC	Cones
AAAGGATTCGTGCATA	Cones
AAAGGGCTCCGTACGG	Rods
AAAGGTACAATCAAGA	MG
AAAGGTATCCCTTCCC	Cones
AAAGTCCCATCGGATT	MG
AAAGTCCGTATCACCA	BC
AAAGTCCGTTCGAGCC	Cones
AAAGTCCTCGCTTAAG	Rods
AAAGTGAAGCTGACCC	Rods
AAAGTGAAGTGAGGCT	Cones
AAAGTGAGTGAGAGGG	Rods
AAAGTGAGTTGTTGCA	PRP
AAAGTGATCCGCAACG	Rods
AAATGGAAGAATCTAG	Cones
AAATGGAAGCCAGAGT	Rods
AAATGGAAGTCAGGGT	MG
AAATGGACAACCTAAC	Rods
AAATGGATCATGGCCG	Rods
AACAAAGAGCATTGTC	Rods
AACAAAGAGTATCTGC	BC
AACAAAGTCCTAGCGG	MG
AACAACCAGCCTCAAT	Cones
AACAACCAGCGATTCT	Rods
AACAACCAGCGGTATG	Rods
AACAACCAGGTACAAT	Rods
AACAACCCAAGTCCAT	Cones
AACAACCCACGAAAGC	Rods
AACAACCCAGTTTGGT	Rods
AACAACCGTGACGTCC	Rods
AACAACCTCATTCGTT	Rods
AACAAGAAGTCAGCGA	Rods
AACAAGACACAGCCTG	Rods
AACACACAGGCGTTGA	MG
AACACACAGTCCCAGC	MG
AACACACGTTGAGTCT	Rods
AACACACGTTGTGCCG	Rods
AACAGGGAGAAGCTGC	Rods
AACAGGGCACAGTATC	BC
AACAGGGTCTTACTGT	BC
AACCAACAGGCGTTAG	Cones
AACCAACCAATGAACA	Cones
AACCAACGTCTCTCTG	Rods
AACCAACGTGGCGTAA	Cones
AACCACAAGGAACTAT	Rods
AACCACACAATGCAAA	BC
AACCACACACCGCTGA	Rods
AACCACAGTCACGCTG	Rods
AACCACAGTTCATCTT	Rods
AACCACATCGCAACAT	Rods
AACCATGAGATGCTGG	MG
AACCATGAGTTGAATG	Rods
AACCATGCAAAGCTAA	BC
AACCATGCACGGTCTG	Cones
AACCATGCAGGCAATG	Rods
AACCATGTCTTCTCAA	Rods
AACCCAAAGTAGTGCG	Rods
AACCCAACAGCGGTTC	MG
AACCCAACATACTGAC	Rods
AACCCAAGTAACGTTC	MG
AACCCAAGTCCGACGT	Cones
AACCTGACACCAGACC	AC/HC
AACCTGAGTCCGTACG	Rods
AACCTGATCCTACAAG	Rods
AACCTTTCAAAGCAAT	Rods
AACCTTTCAGAACTAA	Rods
AACCTTTGTTCGTACA	Rods
AACGAAATCTGTCGCT	MG
AACGGGAAGCATACTC	MG
AACGGGACATATCGGT	MG
AACGGGACATCGTCCT	Cones
AACGTCAAGGTTGGTG	Cones
AACGTCAAGTAGTGCG	MG
AACGTCACAGACGCTC	Rods
AACGTCAGTCTCGGAC	Rods
AACTTCTAGGTTCCGC	Rods
AACTTCTCAAGCGGAT	Rods
AACTTCTCAGAGCTAG	MG
AACTTCTCATATACCG	MG
AAGAACAAGCATCCCG	AC/HC
AAGAACATCGCCAACG	Rods
AAGACAAAGCTCGCAC	BC
AAGACAACAACTCATG	Rods
AAGACAACACTCACTC	AC/HC
AAGACAACACTTGGGC	Rods
AAGACAATCACTGATG	Cones
AAGACTCTCTCTTCAA	Cones
AAGATAGCACGGTGTC	Cones
AAGATAGTCTTGGATG	MG
AAGCATCCAGGGAATC	Rods
AAGCATCCATTCGATG	Cones
AAGCCATAGAACTCCT	Rods
AAGCCATAGAAGGTAG	Rods
AAGCCATCAAGTACCT	Rods
AAGCCATTCTGATTCT	Rods
AAGCGAGGTCAGACGA	BC
AAGCGAGGTCCAGCGT	BC
AAGCGAGTCCTCTAAT	BC
AAGCGTTGTCAGGTGA	Cones
AAGCGTTGTTGGCCGT	Rods
AAGGAATAGAAGATCT	Cones
AAGGAATTCTCTTGCG	Rods
AAGGTAAAGAAGCGAA	Rods
AAGGTAACAACGGTAG	Rods
AAGGTAACAGGCCTGT	Cones
AAGGTAAGTGGCACTC	MG
AAGGTAATCACCTACC	MG
AAGGTAATCTGTCCGT	MG
AAGTACCAGCCATTTG	MG
AAGTACCCACGGTCTG	Rods
AAGTACCGTACGATTC	Rods
AAGTACCGTTGCTCGG	MG
AAGTCGTTCCATACTT	Rods
AAGTGAAAGGTTCAGG	Rods
AAGTGAAAGTAGGCCA	Rods
AAGTGAACAGTTCACA	AC/HC
AAGTGAACATCACCAA	MG
AAGTGAACATCGCTGG	Cones
AAGTGAAGTGTCCGGT	MG
AAGTGAATCATAGGCT	AC/HC
AAGTTCGCACCCTATC	Cones
AAGTTCGGTCCTCAGG	Rods
AAGTTCGTCTTCGTGC	AC/HC
AATAGAGAGGGCAGTT	MG
AATAGAGCAGCAGTCC	PRP
AATAGAGGTCTAGATC	AC/HC
AATCACGCAGGCACAA	Rods
AATCACGGTCGCTCGA	Rods
AATCACGGTCTAGTGT	Rods
AATCACGTCGTAGCTA	Rods
AATCGACCACGCCACA	Rods
AATCGACTCCAGCTCT	Rods
AATCGTGAGTCCTACA	Rods
AATCGTGGTGTTGAGG	Rods
AATCGTGGTTCGAACT	Cones
AATCGTGTCATCCTAT	Rods
AATGAAGAGTCATACC	Cones
AATGAAGAGTCGAGGT	AC/HC
AATGAAGCAATAAGGT	Rods
AATGAAGGTCGCTCGA	BC
AATGAAGTCCGTGGGT	Rods
AATGACCAGGAGTATT	Cones
AATGACCAGGGTGAGG	Rods
AATGACCTCCCGTAAA	Rods
AATGCCACAGTAGAGC	Cones
AATGGAAAGGCGAACT	Rods
AATGGAAAGTTCACTG	Rods
AATGGAACATCGATAC	MG
AATGGAAGTGTTCCTC	PRP
AATGGCTAGCGCCTCA	BC
AATGGCTCACTATCCC	Cones
AATTCCTAGGAATCGC	Rods
AATTCCTCACGCTGAC	BC
AATTCCTCAGTTCTAG	Cones
AATTCCTTCTTACGTT	Cones
AATTCCTTCTTCCGTG	MG
AATTTCCCACCAGCTG	BC
AATTTCCGTCATACCA	Rods
AATTTCCGTGAGTTTC	Rods
AATTTCCGTGGCGTAA	MG
AATTTCCTCTCGCTTG	PRP
ACAAAGAGTACTGGGA	Rods
ACAAAGAGTATCGAAA	Rods
ACAACCAAGATCGGTG	BC
ACAACCATCCTACCAC	Rods
ACAAGCTAGACCATGG	BC
ACAAGCTAGATGCCGA	Rods
ACAAGCTCAAGTTCGT	Rods
ACAAGCTCACGACGTC	Cones
ACAAGCTGTCACAGTT	Rods
ACACAGTAGTCGGCCT	MG
ACACAGTCAGTCGGTC	Rods
ACACAGTCATACGCAT	Rods
ACACAGTGTATAGCTC	BC
ACACAGTGTTAAGGGC	Cones
ACACAGTTCTGTACAG	Rods
ACACCAAAGGGTTTCT	Rods
ACACCAACACTCAGAT	Cones
ACACCAACACTCCGGA	Rods
ACACCAATCGAAGCCC	Rods
ACACCAATCGCTAAAC	Cones
ACACGCGAGCTCGCAC	AC/HC
ACACGCGCAAACACCT	Rods
ACACGCGTCTTTACAC	MG
ACACTGACAAGTGGGT	Rods
